R 5040 3500
NO ./texturexpm/64/redbrick.xpm
SO ./texturexpm/64/diamand.xpm
WE ./texturexpm/64/wood.xpm
EA ./texturexpm/64/purplestone.xpm
S ./texturexpm/64/elon.xpm
F 15,50,60
C 225,150,150



  1111111111
  1001011111
111001011111
100001011111
1001011111
1001011111
1001011111
1001011111
1000011111
1001011111
1001011111
1001011111
1001011111
1001011111
1001011111
1020001111
1000000001
1001011001
1001011001
1001011001
1S00000001
1111111111
