R 941 943
NO ./texturexpm/64/creeper.xpm
SO ./texturexpm/64/diamand.xpm
WE ./texturexpm/64/wood.xpm
EA ./texturexpm/64/purplestone.xpm
S ./texturexpm/sprite/startplatinum.xpm
F 15,50,60
C 225,150,150


111111111111111111111111111111111111111111111111111
100000000000111111110000000000000000000000000000001
100000020000010000010100000000000000000000000000001
100000000000010000010100000000000000000000000000001
100000000000000000011100000000000000000000000000001
100000000000000000000000000000000000000000000000001
100000000000000000000000000000000000000000000000001
100000000000000000000000000000000000000000000000001
102020202020202020000000000000002020202020202020201
102020202020202020202020202020202020202020202020201
10202020202020202020202020202N202020202020202020201
111111111111111111111111111111111111111111111111111
