SO ./texturexpm/64/greystone.xpm
NO ./texturexpm/64/mossy.xpm
EA ./texturexpm/64/greenlight.xpm
WE ./texturexpm/64/redbrick.xpm
S ./texturexpm/sprite/chief.xpm

R 900 600
C 0 	,	0,  200
F 50,50,         40

1111111111111111111111111111111111
100010000000000001  111100000200111
102000000000111N01 1100011000000101
1000100000110000011 1100001000111101
10001100000000000001110111111100001
10001100000100000000111011111000111
1010111110000000200000000000111111
10000000000000000000020000000000001
11111111111111111111111111111111111
