SO ./texturexpm/168/gypte.xpm
NO ./texturexpm/168/grille.xpm
EA ./texturexpm/168/halogris.xpm
WE ./texturexpm/168/haloski.xpm
S ./texturexpm/sprite/117.xpm

R 900 600
C 0 	,	0,  200
F 50,50,         40

1111111111111111111111111111111111
100010000000000001  111100000200111
102000000000111101 1100011000000101
1000100000110000011 1100001000111101
10001100000000000001110111111100001
10001100000100000000111011111000111
1010111110000000200000000000111111
1000000000000000N000020000000000001
11111111111111111111111111111111111
