R 1600 1200
SO		./texturexpm/64/greystone.xpm
NO		 ./texturexpm/64/mossy.xpm
EA		 ./texturexpm/64/eagle.xpm
WE			./texturexpm/64/redbrick.xpm
F 150,150,150
S	./texturexpm/64/sprite.xpm
C 225,240,250

1111111111111111111111111111111
1000000001100000011001100111111
100N000001100000011001100111111
1001111111100110011111100111111
1000001111100110011001100111111
1000001111100000011001100111111
1001111111100110011001100111111
1001111111100110011001100000011
1001111111100110011001100000011
1111111111111111111111111101111
