R 500 500
NO ./texturexpm/64/elon.xpm
SO ./texturexpm/64/greystone.xpm
WE ./texturexpm/64/pillar.xpm
EA ./texturexpm/64/mossy.xpm
S ./texturexpm/sprite/halo4.xpm
C 255,255,255
F 0,80,80




111111111111111111111111111111
100000000000000000000000000001
100020000000020000000000000001
100000000000000000000000000001
100000000000000000000000000001
100000000000200000000000000001
100000000000000000000000000001
100000000000000000000000000001
100000000000000W00000000000001
100002000000000000000000000000111
100000000000020000000000000001
10000020000000000000000000000111
1111111111111111111111111111111
