R 2400 1400
NO ./texturexpm/redbrick.xpm
SO ./texturexpm/greenlight.xpm
WE ./texturexpm/wood.xpm
EA ./texturexpm/purplestone.xpm
S ./texturexpm/haloski.xpm
F 0,00,0
C 225,250,250





       111111111111111111111111111111111111111
  1     10000000101000000000000000101111111111
11111111110110000000011100000020000010001
 111    111111001111111001111111111111111
11  111111111000111111000111
10110001111111011111111111111111
 11101111111110111010100100000011111111111
1100000011010101110000001000111
10002000000000001100000010001
10000000000000000101010000001
110000001101010111110111100111111
111101111 1011101011111011110000011111
11100N01111111101111000000011111111001
  11111      1111   11111111       11111
